    111111111111111111
    100000000000000001
    110000000000000001
    100000000000000001
    100000000000000001
    100000000000000001
    100000000000000001
    100000000011111111
    10000000001
    10000000001111111111
    10000000000000000001
    10000000000000000001
    10000000000000000001
    10000000000000000001
    11111111111111111111