111111111111111111111111111111111111111111
100000000000000000000000000000000000000001
100000000000000000000000000000000000000001
100000000000000000000000000000000000000001
100000000000000000000000000000000000000001
100000000000000000000000000000000000000001
100000000000000000000000000000000000000001
100000000000000000000000000000000000000001
100000000000000000000000000000000000000001
100000000000000000000000000000000000000001
100000000000000000000000000000000000000001
100000000000000000000000000000000000000001
100000000000000000000000000000000000000001
100000000000000000000000000000000000000001
100000000000000000000000000000000000000001
100000000000000000000000000000000000000001
100000000000000000000000000000000000000001
100000000000000000000000000000000000000001
100000000000000000000000000000000000000001
100000000000000000000000000000000000000001
100000000000000000000000000000000000000001
100000000000000000000000000000000000000001
100000000000000000000000000000000000000001
111111111111111111111000000000000000000001
000000000000000000001000000000000000000001
000000000000000000001000000000000000000001
000000000000000000001000000000000000000001
000000000000000000001000000000000000000001
000000000000000000001000000000000000000001
000000000000000000001000000000000000000001
000000000000000000001000000000000000000001
000000000000000000001000000000000000000001
000000000000000000001000000000000000000001
000000000000000000001000000000000000000001
000000000000000000001000000000000000000001
000000000000000000001000000000000000000001
000000000000000000001000000000000000000001
000000000000000000001000000000000000000001
000000000000000000001000000000000000000001
000000000000000000001000000000000000000001
000000000000000000001000000000000000000001
000000000000000000001000000000000000000001
000000000000000000001000000000000000000001
000000000000000000001000000000000000000001
000000000000000000001111111111111111111111